3
15
8
0 0 0 0 0 0 0 0 0 0 0 0 0 0 0
0 0 0 0 0 0 0 0 0 0 0 0 0 0 0
0 0 0 0 0 0 0 0 0 0 0 0 0 0 0
0 0 0 0 0 0 0 0 0 0 0 0 0 0 0
0 0 0 0 0 0 0 0 0 0 0 0 0 0 0
0 7 3 4 4 5 8 3 4 5 9 0 0 0 2
0 12 0 0 0 0 0 0 0 0 13 0 0 0 12
0 12 0 0 0 0 0 0 0 0 13 0 0 0 12
0 0 1 1 1 0 0 0 0 0 0 0 0 0 0
0 0 34 34 34 0 0 7 9 0 0 0 0 0 0
0 0 0 0 0 0 0 12 13 0 0 0 0 0 0
0 0 0 0 0 0 0 12 40 0 0 0 0 0 0
0 0 0 0 0 0 0 12 40 0 0 0 0 0 0
0 0 0 0 0 0 0 0 0 0 0 0 0 0 0
0 0 0 0 0 0 0 0 0 0 0 0 0 0 0
0 0 0 0 0 0 0 0 0 0 0 0 0 0 0
1 1 32 0 31 32 0 0 0 0 0 0 0 0 0
41 42 32 0 31 32 0 0 0 0 0 0 0 0 0
43 44 32 0 33 35 0 0 2 6 0 0 0 0 0
34 34 35 0 0 0 0 0 12 13 0 0 0 0 0
0 0 0 0 0 0 0 0 12 13 0 0 0 0 0
0 0 0 0 0 0 0 0 0 0 0 0 0 0 0
38 38 40 40 40 40 40 14 40 40 38 38 38 38 38
39 40 40 14 40 40 40 40 14 40 40 40 40 39 40
0 0 0 0 0 0 0 0 0 0 0 0 0 0 0
0 0 0 0 0 0 0 0 0 65 0 0 0 0 0
0 0 0 0 0 0 0 0 57 0 0 0 0 0 0
0 0 0 0 0 0 0 0 58 0 0 0 0 0 0
0 0 0 66 47 0 0 68 59 0 0 0 0 0 0
0 0 0 0 0 0 0 0 0 0 0 0 0 0 0
0 0 0 0 0 0 0 0 0 0 0 0 0 0 0
0 0 0 0 0 0 0 0 0 0 0 0 0 0 0
